###################
#    P            #
#         O       #
#   X     O       #
#                 #
#                 #
###################
